@width=28
@height=10
@map=
############################
#........#..k...ee..#.....e#
#.@....#.#..h..e..e.+e..e..#
#......#.#..a.......#.....e#
########.#######..##########
#........#a....#..#         
#h.e.....#h.e..+..#         
####...####....####         
#a.......k+...k+ek#         
#..e...e..#########         
###########                 
