@width=5
@height=5
@map=
#####
#.k.#
#a.h#
#.e.#
##+##