@width=16
@height=5
@map=
##### ##########
#.k.###..k#.e.k#
#.#..+..@.+..e.#
#h.a###a.h#...a#
##+## #############
 #.####....h###...#
 #.+....#e#..+...e#
##.####....a###...#
#a...e######  #####
#.k.....e.k#
#a...e######
#######
