@width=16
@height=5
@map=
##### ##########
#.k.###..k#...k#
#.#..+..@.+..e.#
#...###..h#....#
##### ##########

