@width=16
@height=5
@map=
##### ##########
#.k.###..k#.e.k#
#.#..+..@.+..e.#
#...###a.h#...a#
##### ##########

