@width=11
@height=5
@map=
##### #####
#...###...#
#.#.....@.#
#...###...#
##### #####